11111111111
11001110011
00110001100
00000000000
00000100000
00000000000
00110001100
11001110011
11111111111
00000000000